111111111111111
100000000C00011
1E0000000000C11
1P0000000000011
111111111111111