111111111111111111
100000000000001C11
111C11111111111111
1111111111P1111111
111111E11111111111
100000000000000111
111111111111111111